$
000000000000000000000000
000000000000000000000000
000000000000000000000000
000000000000000000000000
000000000000000000000000
000000000000000000000000
000000000000000000000000
000000000000000000000000
000000000000000000000000
000000000000000000000000
000000000000000000000000
111111111111111111111111
111111111111111111111111
000000000000000000111110
000000000000000000110110
000000000000000001110110
000000000000000001110110
000000000000000001110110
000000000000000001111110
000000000000000001111100
000000000000000001111100
000000000000000000011100
000000000000000000000000
000000000000000000000000
$
